betray	trahir, dénoncer
plumber	plombier
thoughtful	prévenant, pensif, pensive, réfléchi
recycling	recyclage, de recyclage
documentation	documents, documentation
thorough	rigoureux, rigoureuse, minutieux, minutieuse, complet, complète
suffering	souffrance, souffrant
viewing	visionnage, visite
usage	usage, utilisation
goat	chèvre, pervers
characterise	caractériser, définir  comme étant , décrire  comme étant
governmental	gouvernemental
salesman	vendeur (dans un magasin), vendeur, commercial, représentant (de commerce)
chef	chef, chef cuisinier
metaphor	métaphore
washing	lessive, pour la lessive, lavage
knot	nœud, nouer
harassment	harcèlement, brimade, tracasserie
stride	pas, marcher à grands pas
cart	transporter, charrette à bras, panier, charrette, Caddie, caddie
persistent	persistant, continu, persistant, répété, tenace
kneel	s'agenouiller
continuity	enchaînements, continuité
fascinate	fasciner, captiver
sickness	nausée, maladie
underwater	sous l'eau, immergé, aquatique, sous-marin
recreation	recréation, reconstitution, récréation
rehearsal	répétition
clarify	clarifier
pudding	entremets, dessert
spider	araignée, robot
scar	marquer, laisser une cicatrice, cicatrice
imaginative	créatif, créative, imaginatif, imaginative
liaison	intermédiaire, liaison, aventure, liaison
cunt	chatte, salope, pute, con
pearl	perles, de perles, en perles, perle
mug	mug, agresser
cruise	de croisière, faire une croisière, croisière, maintenir sa vitesse
electoral	électoral
printing	écriture en script, écriture en caractère d'imprimerie, imprimerie, tirage, imprimé, impression
ID	identité, identifier, papiers, contrôler l'identité de
tolerate	tolérer
homosexual	homosexuel, homosexuelle
dancing	danse
memorable	mémorisable, mémorable
sour	aigre, acerbe, aigre, acide, dégrader, tourner, tourné
grind	hacher, boulot pénible, boulot répétitif, grincer, moudre, broyer, réduire en poudre
sovereign	souverain, souverain, souveraine
fusion	fusion
melon	au melon, melon
shrink	rétrécir
weed	désherber, le tabac, herbe, se débarrasser de, mauvaise herbe
bourgeois	bourgeois, bourgeoise, bourgeois
quest	quête, se mettre en quête de, être en quête de
compliance	conformité (avec ), souplesse, complaisance, déférence
fatigue	lasser, treillis, fatigue, lassitude, fatigue
robot	automatique, robot
lightning	éclair
melody	mélodie
athletics	athlétisme, de sport, sportif, sport, athlétique
confirmation	confirmation
ideally	parfaitement, idéalement, idéalement
clarity	clarté
feminine	féminin
ant	fourmi
grown-up	d'adulte, adulte, comme un grand, comme une grande
keyboard	à clavier, taper (avec/sur un clavier), clavier
cereal	céréale, céréales, de céréales
clearance	compensation, autorisation, habilitation, espace, dégagement, dégagement, espace, liquidation, enlèvement, autorisation
irrelevant	hors de propos, sans rapport avec
knight	cavalier, chevalier, faire chevalier
fragile	fragile
humble	rendre humble, humble, humble, modeste
staircase	escalier
steer	diriger  (vers ), amener  (vers ), conduire
depart	quitter, dévier de, partir, partir pour
commentary	commentaires, commentaire
notify	informer  de , informer  que
indoor	d'intérieur, à l'intérieur
darts	fléchette, foncer, fléchettes
problematic	problématique, problématique, difficile
rejoice	se réjouir de faire, se réjouir de, prendre plaisir à faire , prendre du plaisir à faire, se réjouir
kindly	gentiment, gentil, gentille, kindly + [base verbale] : ayez la gentillesse de, ayez l'amabilité de + [inf]
loyal	loyal
merger	fusion
passive	passif, passif, passive
wanker	connard
tumble	chute, rouler, course, tomber, chuter, faire une chute
jug	nichons, nibards, pichet
feast	plaisir, bien manger, festin
individually	individuellement, individuellement, séparément
tame	réservé, apprivoiser, domestiquer, apprivoisé, fade, insipide, maîtriser, contrôler, discipliner
enhanced	améliorer
sharpen	rendre plus net, tailler, aiguiser, affûter, perfectionner, développer, améliorer
conductor	contrôleur, contrôleuse, animateur, animatrice, conducteur, chef d'orchestre
armchair	fauteuil
conspiracy	conspiration, complot
herd	foule, troupeau, la masse, rassembler
programming	programmation
cardigan	gilet
worldwide	mondial, dans le monde entier
learner	élève, débutant, débutant, débutante
exhaust	gaz d'échappement, épuiser, pot d'échappement, échappement, épuiser, éreinter, exténuer
pronoun	pronom
tuition	frais de scolarité, cours
cauliflower	chou-fleur
duvet	couette
fitting	équipement, essayage, approprié, pièce
brochure	brochure
doubtful	incertain, douteux, douteuse, pas sûr (de )
credibility	crédibilité, crédulité
stink	odeur de , mauvaise odeur de, puanteur, puer, empester
situate	situer, placer, installer
continuously	en continu
opt	opter pour, choisir de faire , décider de faire
morality	moralité
sexuality	sexualité, sexe
amend	amender, modifier
syndrome	syndrome
polish	cirer, cirage
sketch	faire un croquis de, faire une esquisse de, sketch, faire un croquis, faire une esquisse, croquis
shocking	bouleversant, troublant, vif, vive, scandaleux, scandaleuse
outset	début, commencement
stumble	trébucher
viable	viable
Thai	thaïlandais, thaï, Thaïlandais, Thaïlandaise, nourriture thaï
methodology	méthodologie
confrontation	conflit, affrontement
colourful	haut en couleur, coloré, vif, vive
donor	donateur, donatrice, donneur, donneuse
survivor	survivant, survivante, battant, battante
attain	atteindre
bump	bruit sourd, coup, choc, secousse, toucher, heurter, bosse
harvest	moissonner, moisson
driving	conduite, battant, de conduite, moteur, motrice
formidable	redoutable, impressionnant
mattress	matelas
curiously	curieusement, bizarrement, avec curiosité
unacceptable	inadmissible, intolérable, inacceptable
stairs	marche, escalier
screening	tri, dépistage, projection, sélection
constructive	constructif, constructive
undress	d'uniforme ordinaire, uniforme ordinaire, nudité, déshabiller, se déshabiller
ie	c'est-à-dire
meadow	prairie, champ
backing	soutien, appui, accompagnement, pièce de renfort
varied	modifié, divers, varié
textbook	manuel, manuel scolaire, parfait, typique, classique
entail	impliquer
paradise	paradis
trustee	fidéicommissaire, curateur, fiduciaire
untie	défaire, détacher
momentum	élan
postgraduate	de troisième cycle universitaire, étudiant de troisième cycle (universitaire), étudiante de troisième cycle (universitaire)
ongoing	en cours
coincidence	coïncidence, coïncidence, concomitance, simultanéité
corps	corps
mandatory	obligatoire
starter	entrée, démarreur
academy	école, collège (privé), lycée (privé)
applaud	applaudir
interactive	interactif, interactive, qui interagit avec les autres
journalism	journalisme
fatal	fatal, fatidique
differentiate	se différencier, faire la différence entre  et , faire la distinction entre  et , différencier, distingue, faire la différence entre, faire la distinction entre
fort	fort
revenge	vengeance, venger, revanche
rhetoric	rhétorique
flu	grippe
economical	économique, économe
banker	banquier, banquière
buggy	boghei, boguet, buggy, poussette, bogué
slot	fente, machine à sous
dynamics	dynamique, dynamique, énergique
compact	compact, dense, poudrier, compact, compacter
dough	fric, pognon, flouze, blé, pâte
solidarity	solidarité
cleaning	nettoyage, nettoyant
skeleton	réduit au minimum, squelette
vocational	professionnel, professionnelle
whatsoever	aucun, pas le moindre, quel que, quelle que
sandy	sable, de sable
newsletter	bulletin d'information
enclose	joindre, entourer  de , entourer  avec, entourer
spontaneous	spontané
unwanted	non désiré, non sollicité
spit	postillonner, grésiller, cracher, tournebroche, bruiner, crachiner, salive
archive	archives, archiver
jewel	perle, bijou
delegation	délégation
lecturer	maître de conférences, conférencier, conférencière
inadequate	insuffisant, incompétent, inadapté, inadéquat, inapproprié
quota	quota
wireless	wifi, Wi-Fi, sans fil
Holocaust	holocauste, génocide, incendie, l'Holocauste
speculate	supposer que, spéculer, spéculer sur, s'interroger, se poser des questions
beloved	chéri, adoré
cherry	cerise, rouge cerise, aux cerises, fleur
stool	tabouret
qualified	avoir le droit de faire, mitigé, qualifié, qualifié pour
nutrition	nutrition, valeur nutritionnelle
listener	oreille indiscrète, auditeur, auditrice, personne à l'écoute
copyright	droit d'auteur
explicitly	de façon sexuelle, de manière sexuelle, explicitement, clairement, explicitement, ouvertement
axis	l'Axe, axe
unfamiliar	inhabituel, inhabituelle, inconnu, mal connaître
node	nodule, nœud
sticker	autocollant, bardane, épine
predictable	prévisible
trophy	trophée
prosperity	prospérité
shell	coquille
timing	date, chronométrage, minutage, rythme, timing
rightly	correctement, légitimement
flourish	bien pousser, fioriture, prospérer, grand geste, geste ample, moulinet
Kurdish	kurde
transcript	relevé de notes, transcription
cutting	coupe, découpe, coupure, bouture, pénétrant, glacial, acerbe, caustique
enormously	énormément
planner	planificateur, planificatrice
colonel	colonel
exclusion	exclusion
spectacle	lunettes, spectacle
gathering	collecte, assemblée, assemblée, réunion, fête
coordinator	coordinateur, coordinatrice
legendary	légendaire, légendaire, mythique
vomit	vomir, vomi
spinach	épinards, aux épinards, épinard
exploitation	exploitation
span	espace, portée, couvrir, recouvrir
forge	façonner, forger, imiter, contrefaire
relaxation	détente, décontraction, relaxation, relaxation, relaxation, décontraction
enlarge	s'agrandir, agrandir
Hungary	Hongrie
moan	gémissement, se plaindre, gémir
imprison	emprisonner, emprisonner, mettre en prison
uneasy	mal à l'aise, gêné, embarrassé, difficile, désagréable
regain	regagner, reprendre
amateur	amateur, amatrice
ferry	ferry, transporter
subsidiary	secondaire, filiale
stunning	magnifique, éblouissant
detention	retenue, détention
temper	mauvais caractère, tempérer, humeur
overview	vue d'ensemble
charming	Charmant !, Sympa !, charmant
noble	noble
scrutiny	regard insistant, examen (approfondi)
migration	migration, émigration
valuation	estimation, évaluation, expertise
saucepan	casserole
MA	Massachusetts, titulaire d'un master de lettres, master de lettres
pyjamas	pyjama
diameter	diamètre
stakeholder	partie intéressée, responsable
nursing	profession d'infirmier, profession d'infirmière, qui tête, qui allaite, qui donne le sein, soins, soins infirmiers
occurrence	circonstance, occasion, événement, fait
prospective	futur
Sri Lanka	Sri Lanka
conjunction	conjonction
fabulous	fabuleux, fabuleuse
multimedia	multimédia
allowance	marge de tolérance, concession, argent de poche, allocation
butterfly	papillon
manuscript	manuscrit
headteacher	directeur, directrice
worm	soutirer  à, vers, vermifuger, ver de terre, ver, ver, minable
browser	fureteur, fureteuse, navigateur
semester	semestre
selected	sélectionner, surligner, sélectionner, choisir, sélect
pasta	pâtes
supposedly	soi-disant
strap	sangler  à , attacher  à, sangle, courroie, lanière
fuck	coup, sale con, baiser  avec, baise, baiser, niquer, merde, merde alors, carotter  à , carotter  de
dwelling	habitation, demeure
greeting	salutation, bonjour, vœu, vœux
breathing	qui respire, respiration
threshold	aube, seuil, porte
vase	vase
vein	veine
hospitality	hospitality industry/sector : l'hôtellerie, hospitalité
sailor	matelot, marin
knackered	crevé, claqué
bizarre	bizarre, étrange
propaganda	propagande
mould	moule, façonner, former, forger, faire  de, modeler, façonner, moisissure, modeler, façonner, forger
mainstream	scolariser  dans une école normale/classique, normal,  classique, populaire, courant dominant, populariser, traditionnel, traditionnelle
sweater	pull, pull-over
hockey	hockey sur gazon, de hockey sur gazon, hockey, hockey sur glace, de hockey, de hockey sur glace
instrumental	contribuer (grandement) à, instrumental, morceau instrumental, jouer un rôle (important)
lid	couvercle, paupière
activate	mettre sur pied, monter, activer
stereotype	stéréotyper, stéréotype
decisive	résolu, décidé, décisif, décisive, clair, certain
freezer	congélateur
visa	Visa, carte Visa, visa
profitability	profitabilité, rentabilité
despair	désespoir, désespérer, désespérer de faire, désespérer de
bacon	bacon, au bacon, avec bacon, oseille, blé
mobility	mobilité
orthodox	conventionnel, conventionnelle
prestige	prestige
nominate	nommer  à, nommer, désigner  pour faire, désigner, nominer, nominer  pour
unreasonable	déraisonnable, excessif, excessive
luxury	luxe
distress	détresse, désarroi, bouleverser, ébranler, désoler
trumpet	barrir, trompette, barrissement, clamer, proclamer, claironner
toxic	toxique, nocif, nocive
binding	liens, reliure, extrafort, qui engage , qui lie
alike	de la même manière, semblable
fantastic	fantastique, sensationnel, merveilleux
livestock	bétail
technically	techniquement
articulate	exprimer, prononcé clairement, qui parle bien, qui s'exprime bien, clair et précis, bien parler
outbreak	explosion, épidémie
organiser	organiseur, agenda, organisateur, organisatrice
insistence	insistance
unprecedented	sans précédent
consistency	cohérence, homogénéité, uniformité, régularité, cohérence, consistance
keeper	soigneur (animalier), soigneuse (animalière), gardien, gardienne
obscure	cacher, obscur
subjective	subjectif, subjective
commentator	commentateur, commentatrice
confession	confession, aveu
calendar	calendrier, agenda
banner	drapeau, bandeau, gros titre, banderole
bass	basse, guitare basse, bar, de basse, grave, basse, contrebasse, les graves, les basses
poorly	mal, souffrant, malade
finished	fini
provincial	provincial, provinciale, provincial
peach	couleur pêche, pêche, pêcher
trained	diplômé, qualifié, entraîné
graphics	vivant, graphique, image, illustration, arts graphiques, explicite, graphismes
punk	punk, punk rock, voyou
blessing	bénédicité, bénédiction
chunk	gros morceau
invaluable	inestimable
likewise	de même
nationalism	nationalisme
civic	municipal, éducation civique, civique
dodgy	louche, bizarre, suspect, fragile, peu solide, mauvais, médiocre, risqué, dangereux, malhonnête
toll	bilan, sonner, péage
distinguished	éminent, distingué
accumulate	s'accumuler, accumuler
dense	opaque, bête, idiot, difficile à comprendre, dense, compact
autonomous	autonome
drill	faire faire des exercices de  à, percer  dans , forer  dans, fraise, roulette, percer, forer, perceuse, forer pour trouver, exercice, faire faire des exercices à
census	recensement, recenser
inappropriate	indécent, déplacé, inapproprié, inconvenant, inapproprié, déplacé
eyebrow	sourcil
rib	côtes, nervure, côte, couple
cautious	prudent
contempt	mépris, mépris, dédain, outrage
formally	officiellement, solennellement, officiellement
municipal	municipal
pretend	faire semblant de faire, faire semblant de ne pas faire, jouer à, pour jouer, faire semblant, factice, faire semblant que...
urine	urine
reconstruction	reconstitution, reconstruction
emergence	émergence
believer	croyant, croyante, partisan
extract	extrait, extraire, soutirer, arracher
redundant	redondant, licencié
added	supplémentaire
making	fabrication
overnight	en 24 heures, du jour au lendemain, d'une nuit, dans la nuit, la nuit, instantané, immédiat
interim	provisoire, entre-temps, en attendant
harmful	dangereux, dangereuse, nocif, nocive, nuisible
mining	exploitation minière
appropriately	de façon appropriée, de façon convenable
Brazilian	maillot brésilien, brésilien, brésilienne, Brésilien, Brésilienne
alert	alerte, mettre  en garde contre, alerter, vigilant
fucking	foutu, fichu, satané, putain de, vraiment
auction	vendre aux enchères, vente aux enchères
deteriorate	se détériorer, se dégrader
formulation	élaboration, formule, formulation
coherent	cohérent
constraint	contrainte, restriction, contrainte
maximise	maximiser, exploiter au maximum
psychiatric	psychiatrique
quantitative	quantitatif, quantitative
complication	complication
transplant	transplant, venir d'une autre région/d'un autre pays, transplanter, greffer, transplanter  dans , greffer  dans, transplanter, déplacer, transplantation, greffe
forecast	météo, prévoir, annoncer, prévisions, prévoir
parameter	paramètres, paramètre
loving	tendre, aimant
goose	oie
pro	pro, avantage, pour, un pro, une pro
linear	linéaire
pea	petit pois, aux pois, pois
vinegar	mauvais caractère, vinaigre
inject	faire une injection à, injecter, injecter  à , faire une injection de  à, injecter  dans
vocal	qui se fait entendre, chant, chanté, vocal, vocal
disappointing	décevant
unbelievable	incroyable
historically	historiquement
Lebanon	Liban
chimney	cheminée
passionate	passionné, dévoué, passionné, passionné, ardent, passionné par
pioneer	pionnier, pionnière
validity	validité
sofa	canapé, sofa
controller	responsable, manette, contrôleur, contrôleuse, directeur, directrice, appareil de contrôle, régulateur
likelihood	probabilité
seasonal	saisonnier, saisonnière
functionality	fonctionnalité
required	être tenu de faire, nécessaire, requis, obligatoire
slab	bloc, table d'opération, table d'autopsie, trancher, grosse part
Malaysian	malaisien, malaisienne, Malaisien, Malaisienne
rage	colère, faire rage, rage, colère, rager, enrager
analogy	analogie
arouse	exciter, susciter, éveiller, réveiller
flock	ouailles, effet velours, bourre, aller en groupe, aller en masse, affluer, s'attrouper, volée, nuée, troupeau
maturity	échéance, maturité
locality	, région
accord	accord, s'accorder avec, accorder  à, accord, consentement
ray	ré, raie, rayon
am	suis
shag	à poils longs, s'envoyer en l'air, dégradé flou, s'envoyer en l'air avec, partie de jambes en l'air, cormoran, tapis à poils longs
consecutive	consécutif, consécutive
injection	vaccin, injection, piqûre
monitoring	surveillance
pdf	PDF, pdf
proceeds	bénéfices
nappy	couche, couche pour adultes, couche adultes, couche
citizenship	citoyenneté, nationalité, éducation civique, civisme
testing	essais, tests, d'essai, éprouvant, compliqué
integral	intégrant, integral part : composant
verify	vérifier, confirmer
scenario	scénario
innovative	innovateur, innovatrice, novateur, novatrice
slogan	slogan
texture	texture, consistance, caractère, texture
tiger	tigre
monastery	monastère
jurisdiction	juridiction
entitlement	droit, croire que tout vous est dû
disclosure	divulgation, révélation, divulgation
condemnation	condamnation
greenhouse	serre
drip	égouttement, goutter, goutte, perfusion
comparatively	relativement
temporarily	temporairement
mini	mini
offender	délinquant, délinquante, coupable
forbid	défendre à  de faire , interdire à  de faire, interdire
bad-tempered	irascible, colérique
anchor	soutien, présentateur, présentatrice, ancre, ancre HTML
continually	continuellement
raised	surélevé
distract	détourner  de, détourner l'attention de, détourner l'attention de  de, distraire
carbon dioxide	dioxyde de carbone
invention	inventivité, imagination, invention, invention, fabrication
frightened	effrayé, avoir peur de
smack	gifler, gifle, claque
conquer	conquérir, vaincre, battre, conquérir
sadness	tristesse
trainee	stagiaire
thrill	frisson, vibrer pour , frémir pour, ravir, enchanter, vibrer, frémir, sensation forte
salon	salon de coiffure, salon, institut de beauté, salon de beauté
voucher	bon
array	tableau, éventail (de ), étalage (de )
failed	qui a fait faillite, raté
question mark	point d'interrogation
pissed	bourré, beurré, torché, pété, furieux, furieuse
optical	optique
balloon	grossir, s'envoler, ballon de baudruche, ballon, montgolfière, gonfler
entertaining	divertissant, distrayant, amusant, recevoir
standpoint	position, point de vue
tremble	trembler
molecular	moléculaire
warrior	guerrier, guerrière
compatible	compatible
workplace	lieu de travail
tease	aguicher, mettre en appétit, taquin, taquine, allumeur, allumeuse, crêper, provoquer, se moquer de, embêter, ennuyer
privately	à titre privé, à titre individuel, dans une école privée, dans l'enseignement privé, secrètement, intérieurement, en privé
lighten	détendre, éclaircir, éclairer, se dérider, s'égayer, alléger, s'éclaircir, s'alléger
adaptation	adaptation
multiply	multiplier, se multiplier
ribbon	ruban
disturbing	troublant, inquiétant, perturbant, bouleversant
tread	marcher, chape, marcher sur, fouler
broker	négocier, courtier en bourse, courtière en bourse
redundancy	licenciement, licenciement économique, redondance
overlap	chevaucher, chevauchement, se chevaucher
telescope	plier, replier, télescope, condenser
authentic	authentique
wholly	complètement, entièrement, complètement, entièrement, tout à fait
helmet	casque
projection	projection, prévision, saillie, projection
precision	précision
cushion	coussin, amortir, coussin, matelas
detection	découverte, détection
vendor	vendeur, vendeuse
absurd	absurde, ridicule, l'absurde
convincing	réaliste, persuasion, convaincant
inequality	inégalité
rehabilitation	réhabilitation, réinsertion, rééducation
supportive	qui soutient, de soutien, d'accompagnement, soutenir, encourager, qui soutient  (bien, beaucoup), qui aide  (bien, beaucoup), qui encourage
unify	unifier, s'unifier
gymnastics	de gymnastique, gymnastique
kidney	rognon, rein
dairy	laitier, laitière, exploitation laitière, laiterie, produits laitiers
batch	fournée, grouper, regrouper, lot
gorgeous	superbe, splendide
update	mettre à jour, tenir  au courant (de ), mettre  au courant (de ), informations, dernières informations, mettre à jour, actualiser, mise à jour
freezing	congélation, gelé
incapable	incapable, incompétent, incapable de (faire)
delicious	délicieux, délicieuse
fixture	rencontre, équipement, revenir régulièrement
architectural	architectural
burial	enterrement
glorious	glorieux, glorieuse, splendide
rod	canne, tige, bâton, coup de bâton, coup de baguette, coup de verge
ethical	d'éthique, éthique, moral
democrat	démocrate
aspiration	aspiration
registered	inscrit, déclaré, enregistré, déclaré
permanently	définitivement
worthy	noble, louable, digne de, digne, honorable, louable, méritant, méritant
accusation	accusation
minus	sans, sauf, moins
supervisor	directeur de thèse, directrice de thèse, superviseur
winning	gagnant, de la victoire, gagner, gains
placement	placement, disposition
revival	renaissance, retour, reprise
walker	déambulateur, trotteur, marcheur, marcheuse
nicely	bien
brigade	brigade
developed	urbanisé, développé, adulte
corpse	corps, cadavre
simplicity	simplicité
foster	promouvoir, encourager, nourrir, entretenir
violation	violation, viol
miserable	triste, pitoyable, affreux, affreuse, épouvantable, horrible, pourri, misérable, malheureux, malheureuse
expel	renvoyer, exclure, renvoyer  de , exclure  de, émettre, dégager, rejeter
vacuum	passer l'aspirateur dans, aspirateur, vide
roam	traîner dans, errer dans, errer, vagabonder
theology	théologie
telly	télé
contributor	donateur, donatrice, contributeur, contributrice
embarrassed	gêné, embarrassé
honesty	honnêteté
surrender	rendre, se rendre, reddition, capitulation, abandonner, remettre
microphone	micro
appliance	appareil
dragon	dragon
roundabout	rond-point, indirect, manège
Sudan	Soudan, le Soudan
prose	prose, en prose
gospel	l'Évangile, parole d'évangile, Évangile, gospel
eagle	aigle
presenter	présentateur, présentatrice, personne qui remet un prix, personne qui remet une récompense
coordination	coordination
abundance	abondance
pat	petite tape, caresser, tapoter, parfaitement, tout fait
reproduction	reproduction, copie, reproduction
presume	oser faire, présumer, supposer, présumer que, supposer que
probe	enquête, investigation, sonde, enquêter sur, interroger  pour obtenir, interroger, sondage, sonder
denial	déni, démenti
horizontal	horizontal
abnormal	anormal
undertaking	projet, engagement
eternal	continuel, continuelle, immuable, éternel, éternelle
stab	coup de couteau, poignarder, poignarder  dans
reasoning	rationalisation, réflexion
diabetes	diabète
garment	vêtement
diagnose	diagnostiquer  (à ), diagnostiquer  à, diagnostiquer, identifier, faire un diagnostic, faire des diagnostics, poser un diagnostic, poser des diagnostics
honourable	honorable, honorable, respectable, d'honneur
unclear	pas clair
worrying	inquiétant
upgrade	mettre à jour, mettre à niveau, actualiser, surclasser, promotion, passer à une version supérieure, passer à un système supérieur, promouvoir, surclassement, mise à jour, mise à niveau, actualisation, dernière version, mise à jour, mise à niveau, actualisation
walking	marcher, randonnée, randonnée pédestre
torture	torturer, torture
confidential	confidentiel, confidentielle, de confiance
tricky	difficile, délicat, difficile, fourbe, sournois, rusé
farming	agricole, agriculture
admiration	admiration
encompass	inclure
dual	double
cube	élever au cube, élever à la puissance trois, cube, découper en cubes, découper en dés
inheritance	héritage
developmental	de croissance, de développement
gossip	commérer, cancaner, jaser, commérer sur, cancaner sur, jaser sur, ragots, commérages, commère, bavarder, discuter
fortunate	chanceux, chanceuse
cult	culte, secte, à qui on voue un culte
tolerance	tolérance
pillar	colonne, pilier, soutien, pilier
vegetation	végéter, végétation
applicable	applicable à, applicable, en vigueur
lesser	le plus petit (de ), moindre, plus petit
frankly	franchement, franchement, ouvertement
biography	biographie
wit	homme d'esprit, femme d'esprit, esprit, présence d'esprit
bless	doter  de, gâter, bénir
salesperson	représentant (de commerce), représentante (de commerce), vendeur, vendeuse (dans un magasin)
configuration	configuration
foolish	imprudent, ridicule, bête, idiot, stupide
mistress	maîtresse
sprinkle	vermicelles, mettre  dans , ajouter  à, asperger  de, une pincée de, saupoudrer  de
dependence	dépendance, dépendance à
efficiently	efficacement
bolt	se ruer dehors, se précipiter dehors, verrou, verrouiller, se ruer hors de, se précipiter hors de, boulonner, s'emballer, vis
follower	adepte (de ), follower, fan, partisan, partisane
credible	fiable, crédible
activist	activiste
latitude	latitude
murderer	meurtrier, meurtrière
acquaintance	connaissance, connaissance de
unpleasant	désagréable, déplaisant, désagréable
freely	librement
pistol	pistolet
quotation	citation, cotation, devis
ham	jambon, au jambon
weave	tresser, tisser
disguise	déguiser  en, dissimuler, cacher, masquer, déguisement
penetrate	pénétrer, pénétrer dans, percer
linen	en lin, linge, linge de maison, lin
biblical	biblique
genre	genre
strangely	étrangement, bizarrement
fond	aimer faire , adorer faire, aimer, adorer, affectueux, affectueuse, fou, folle
prescribe	prescrire
ascertain	vérifier
genius	génie, don (extraordinaire)
presently	bientôt, actuellement, maintenant, en ce moment
Syria	Syrie
tablet	tablette, comprimé, cachet
plaster	plâtrer, enduire  de , enduire  sur , recouvrir  de, pansement (adhésif), afficher, plâtre, recouvrir  de
firefighter	pompier
wounded	blessé
accelerate	accélérer
coaching	entraînement
hormone	hormone
blast	coup, s'éclater, se marrer, explosion, abattre, faire sauter, faire exploser, être tiré, mince, zut, coup de
olive	olive, vert olive, olive, vert olive, aux olives
embassy	ambassade
illuminate	illuminer, éclairer, enluminer
collision	collision, conflit, choc
deadline	date limite, date butoir
financially	financièrement
critique	critique, faire la critique de
statutory	statutaire
reconcile	rapprocher  et, faire accepter  à, réconcilier  et , réconcilier  avec, concilier  et, se réconcilier, se faire à
workforce	main-d'œuvre
apologise	s'excuser de , s'excuser d'avoir fait, présenter ses excuses, faire ses excuses, présenter des excuses à  pour, présenter ses excuses à , faire ses excuses à, présenter ses excuses à  pour avoir fait
ample	fort, corpulent, largement assez de, suffisamment de, beaucoup de + [nom singulier ou pluriel]
presidency	mandat présidentiel, présidence
vest	gilet, maillot de corps, tricot de corps, débardeur
shove	pousser, bousculer, fourrer, mettre, pousser
wheelchair	fauteuil roulant
neighbouring	voisin, limitrophe
liberation	émancipation, libération
scarf	assembler  bout à bout, enter, assemblage, assemblage en biseau, enture, engloutir, couper le lard de, foulard, lard, écharpe
exclusively	en exclusivité, exclusivement
boast	se vanter de, posséder, compter, se vanter de faire , se vanter d'avoir fait, se vanter de faire, se vanter
virgin	inaugural, vierge, pur, sans alcool, la Vierge, vierge
monk	moine
disrupt	perturber, bouleverser
exemption	exemption, exonération
whichever	n'importe lequel, n'importe laquelle, quel que soit, quelle que soit, qu'importe
nomination	proposition, nomination
infrastructure	infrastructure
beneficial	bénéfique
Ghana	Ghana
saleswoman	vendeuse, commerciale, vendeuse (dans un magasin), représentante (de commerce)
territorial	territorial, de l'armée territoriale (britannique)
throne	trône
striking	saisissant, frappant, frappant, saisissant, remarquable
donate	donner, donner à, donner  pour, donner  à
balanced	objectif, objective, équilibré
bombing	bombardement, de bombardement
teapot	théière
legally	juridiquement, légalement
optimism	optimisme
scary	effrayant, effrayant, terrifiant
handbook	livre
inspect	examiner, inspecter, examiner de près, examiner avec attention
embed	enfoncer  dans , implanter  dans , insérer  dans, enraciner, ancrer, intégrer, enfoncer, implanter
ironing	repassage
furnish	fournir, fournir  à, meubler
rental	locatif, locative, location, loyer
curse	malédiction, calamité, sort, maudire, les règles, jurer, insulter
allocation	répartition, distribution, allocation
disposition	tendance, tempérament, naturel, disposition, humeur
steering wheel	volant
squash	squash, courge, écraser, aplatir
jerk	tirer d'un coup sec sur, coup sec, connard, connasse, le jerk, faire un mouvement brusque
vivid	frappant, vivant, vif, vive, fertile, débordant, net, nette, précis
grape	raisin, bordeaux, vigne
infinite	infini
tourism	tourisme
majesty	Majesté, majesté
gloomy	sombre, triste
noun	nom
artwork	œuvre, artwork
independently	indépendamment, de façon indépendante, de manière indépendante
rotten	méchant, pourri, avarié, pourri
cheer	merci, applaudir, bonne humeur, acclamer, applaudir, salut, santé, hourra
genuinely	sincèrement, vraiment, réellement, sincèrement
distributor	distributeur, distributeur, distributrice
pedestrian	piéton, piétonne, banal, convenu
courtesy	politesse, courtoisie
lick	plan de guitare, coup de langue, petit coup de peinture, lécher
salvation	salut, sauvetage, salut
supervise	surveiller, superviser, encadrer
next door	à côté de chez, à côté, d'à côté
rewind	rembobiner
pony	poney
socket	orbite, prise (de courant), cavité
halfway	quelque peu, à mi-chemin
profitable	rentable
pottery	poteries, poterie
liberate	libérer, libérer  de
interface	interface
renew	renouveler
swap	échanger  pour, échange, échanger
stack	mettre en rayon, étagères, pile, empiler  sur, des tas de, to stack shelves : s'occuper de la mise en rayon, mettre en rayon, tas
bitch	se plaindre, garce, chienne, chiant, salope, se plaindre de, râler, rouspéter, dire du mal de
footpath	sentier, trottoir
deem	considérer  comme étant , considérer que  est, juger, estimer, considérer, juger  être
dean	doyen, doyenne, doyen
reactor	réacteur
bun	chignon, petit pain
gig	concert
ignorance	ignorance
unfortunate	maladroit, malheureux, malheureuse
appetite	appétit, goût (pour )
terrain	terrain
oversee	superviser, surveiller
synthesis	synthèse
rack	tenailler, ronger, tourmenter, torturer, dévaster, -, étagère
unconscious	inconscient, inconscient, évanoui
shorts	court, sec, sèche avec, petit, diminutif de, ne plus avoir de
inquire	se renseigner, demander si/quand/comment/qui/ce que, demander des nouvelles de, se renseigner sur, examiner, demander
congregation	congrégation, assemblée des fidèles, rassemblement, groupe
exhausted	épuisé, éreinté, exténué, harassé, fourbu, éreinté, exténué
fashionable	chic, à la mode
prototype	prototype
misery	grande tristesse, misère
regeneration	régénération, revitalisation, repousse
old-fashioned	démodé
intellect	intelligence, intellect, grand esprit
choir	chœur, chorale
mist	larmes, vaporiser, bruiner, buée, fines gouttes, fines gouttelettes, brume, se brouiller
swamp	submerger  (de ), surcharger  (de ), inonder, submerger, marais, submerger  de, submerger
secular	profane, laïque
microwave	cuire au micro-ondes, micro-onde, micro-ondes
temptation	tentation
assertion	affirmation, assertion, revendication
asylum	asile
bracket	mettre entre parenthèses, crochet, parenthèse, tranche, tableau
bundle	empaqueter, paquet, offre groupée
pyramid	pyramide
pigeon	pigeon
globe	globe, globe (terrestre), le monde
bark	mendiant, écorce, aboiement, aboyer
diplomat	diplomate
amazed	étonné, stupéfait, ébahi
heir	héritier, héritière
likes	vouloir, désirer, genre, aimer bien, comme, aimer beaucoup, aimer, aimer (bien) faire
default	ne pas s'acquitter d'une dette, non-comparution, défaut de paiement, inaction, ne pas payer, ne pas rembourser, par défaut, valeur par défaut
urgency	urgence
cocktail	cocktail
daylight	journée, lumière du jour, matin
Norwegian	Norvégien, Norvégienne, norvégien, norvégienne, norvégien
pussy	chatte, minou, fillette
financing	financement
static	électricité statique, statique
cruelty	cruauté, insensibilité
urgently	avec insistance, d'urgence
printed	imprimé
spatial	spatial
arc	décrire un arc, arc
discard	rejeter, abandonner, laisser tomber, jeter
correction	correction
cleaner	plus propre, homme de ménage, femme de ménage, nettoyant, détachant
compartment	compartiment
antique	d'antiquités, objet ancien, ancien, ancienne, antique
loser	raté, ratée, perdant, perdante
Iceland	Islande
bloody	fichu, foutu, satané, maudit, sanglant, saignant, -, faire saigner, couvrir de sang, super
torch	torche, lampe de poche, chalumeau, cramer
giraffe	girafe
lengthy	très long, trop long, long, longue
excessive	excès de , excédent de, excessif, excessive
strive	s'efforcer de faire, faire des efforts, faire tout son possible
collaborate	collaborer
communism	communisme
hen	poule
demonstrator	démonstrateur, démonstratrice, manifestant, manifestante
disco	disco, discothèque, boum
graphic	vivant, graphique, image, illustration, arts graphiques, explicite, graphismes
paw	tripoter, peloter, patte, donner un coup de patte à
sceptical	sceptique
designate	marquer, désigner, nommer, indiquer, dénoter
disruption	perturbation, interruption
hostility	hostilité, hostilités
lottery	loterie
mailing	mailing, postal
referral	renvoi juridique, envoyer  vers un spécialiste, adresser  à un spécialiste, personne référée, personne envoyée (vers )
thorn	épine
optional	optionnel, optionnelle, en option
emperor	saturnie, empereur
rotate	tourner, alterner, faire tourner
transit	passage, de transport, en transit, transport, transports en commun, transit, traversée
terminate	mettre fin à
postpone	reporter le fait de faire , remettre à plus tard le fait de faire, reporter, remettre à plus tard
sidewalk	trottoir
adequately	suffisamment, correctement, convenablement
heart attack	crise cardiaque
intensify	s'intensifier, intensifier, renforcer, forcir, accentuer, exacerber, intensifier
nucleus	noyau
openly	franchement, publiquement
warehouse	entrepôt, magasin
adverse	contraire, négatif, négative
salmon	rose saumon, saumon
literacy	lire et écrire
understandable	compréhensible
wardrobe	garde-robe, armoire, penderie, garde-robe
apparatus	appareil, équipement, instrument, dispositif, mécanisme
deed	acte notarié, acte de propriété, acte
immune	immunisé, immunitaire, exonéré, exonéré de, à l'abri de, immunisé contre
bride	mariée
fringe	frange, périphérie, bordure, la marge de, extrêmes, partis d'extrême-gauche et d'extrême-droite
mathematical	mathématique
hail	grêle, héler, déluge (de ), grêler
template	gabarit
computing	informatique
risky	risqué
exotic	exotique
injured	blessé, les blessés
delightful	agréable, charmant
revive	ranimer, réanimer, relancer, raviver, revigorer, se remettre, se rependre
sibling	frère ou sœur
soak	faire tremper, tremper
advisory	alerte, de renseignement, d'information, consultatif, consultative
grid	réseau, grille
respective	respectif, respective
dive	plonger, plongeon
bleed	purger, déteindre, hémorragie, dépasser, saigner
prevail	l'emporter sur, convaincre  de faire, battre, prévaloir, prédominer,  être le plus important
shaft	baiser, hampe, cage d'ascenseur, puits, conduit, tige, entuber, mât, manche, rayon, rayon de lumière
insurer	assureur
retrieve	extraire, récupérer, récupérer
balcony	balcon
token	jeton, marque, symbolique
secretly	en son for intérieur, en secret, en cachette
mighty	super, puissant
niece	nièce
dentist	le dentiste, la dentiste, dentiste
combat	treillis, combat, combattre
renewal	reprise, renouvellement, rénovation
redeem	échanger, échanger  contre, récupérer, racheter
embryo	idée à l'état embryonnaire, embryon
sincerely	cordialement, sincèrement
Arabia	péninsule d'Arabie
trivial	futile, sans intérêt, banal, insignifiant
frog	grenouille, hausse, Français, Française
kindergarten	école maternelle, maternelle
voltage	tension
compensate	indemniser  pour , dédommager  de, indemniser, dédommager, se faire pardonner d'avoir fait, compenser, contrebalancer
rating	note, classification, audimat, 18 rating : interdit aux moins de 18 ans
invade	envahir, violer
cafe	cafétéria, café
bothered	préoccupé, préoccupé par, avoir envie (de faire ), avoir envie de faire
positively	de façon positive, de façon constructive, indéniablement, irréfutablement, absolument, par l'affirmative, positivement, véritablement
spectator	spectateur, spectatrice
summarise	résumer
uphold	faire respecter, maintenir, confirmer, maintenir
bang	frange, coup, marque, détonation, cogner, heurter, claquer, en plein
realm	domaine, royaume
glimpse	lueur, étincelle, aperçu, entrevoir, apercevoir
Malta	Malte
picnic	pique-nique
healthcare	relatif aux services de santé, services de santé
appreciation	goût, reconnaissance, apprécier, appréciation, revalorisation
bung	boucher, mettre, bouchon
headmaster	directeur (d'école)
adjective	adjectif, adjectival
legacy	héritage
anymore	(ne…) plus, de nos jours
technician	technicien, technicienne
faithful	fidèle, exact, fidèle, loyal, fidèle
preach	prêcher, faire la morale
query	requête, interrogation, question, mettre en doute
altar	autel
intermediate	intermédiaire, de niveau intermédiaire
potty	dingue, taré, cinglé, pot
courtyard	cour
cultivate	cultiver
privacy	intimité
annually	annuellement
specialty	spécialité
delete	supprimer, effacer, supprimer, Suppr
rug	tapis, couverture
partially	partiellement
beep	bip, klaxonner, bipper
repay	remercier  (de/pour ), rendre, rembourser
predominantly	majoritairement, principalement
Satan	Satan
grouping	groupe, rassemblement, groupement
beautifully	merveilleusement, merveilleusement, divinement, magnifiquement
badge	insigne, badge, un gage de, badge (scout)
nationally	nationalement
convenience	avantage
Uganda	Ouganda
authorise	autoriser, autoriser  à faire
aggression	agression contre, agression, agressivité
thrive	prospérer, bien se porter
skip	sauter, passer, sautiller, sauter à la corde, ne pas aller à, sautillement
kettle	chaudière, bouilloire, marmite
stain	tacher, teindre, lasurer, tache, teinture
fuss	difficultés, pataquès, histoires, tapage
exchange rate	taux de change
nephew	neveu
utterly	tout à fait, complètement
coup	coup d'État, joli coup
divert	divertir, amuser, dévier, réaffecter, distraire
recycle	recycler
monarchy	monarchie
discourage	décourager, démoraliser, dissuader  de faire, dissuader  (de faire )
payable	comptes fournisseurs, comptes créditeurs, rédigé  à l'ordre de, établi à l'ordre de, exigible, payable, payable
inclusion	inclusion, intégration
marine	marin
endeavour	entreprise, s'efforcer de faire, effort
honestly	franchement !, honnêtement, franchement, vraiment
referendum	référendum
bulletin	communiqué, bulletin d'informations
pastry	pâtisserie, viennoiserie, pâte
eligible	avoir le droit de vote, en droit de faire, éligible, convoité, avoir droit à
albeit	bien que
inherent	inhérent, intrinsèque
refuge	refuge, asile, abri, refuge, asile, refuge, abri
reconciliation	rapprochement, rapprochement bancaire, rapprochement comptable, réconciliation
endure	durer, perdurer, survivre, endurer
offering	don, cadeau, offrande
arena	stade, arène
babe	chéri, chérie, canon, bébé
philosophical	philosophique, philosophe
steering	conduite, direction
idiot	idiot, idiote
descendant	descendant, descendante
rebuild	restaurer, rétablir, restructurer, réorganiser, reconstruire
logo	logo
publishing	d'édition, édition
morally	moralement
noticeable	visible, notable, visible
applied	appliqué
philosopher	philosophe
racist	raciste
shrub	arbuste
allegedly	prétendument
dispatch	expédier, envoyer, tuer, abattre, expédier  à , envoyer  à, envoyer  faire
deliberate	mûrement réfléchi, bien pesé, circonspect, délibérer, étudier, délibéré
scrap	ferraille, (petit) bout, déchets
notorious	tristement célèbre
compile	dresser
therapist	thérapeute
portable	portable, transportable, portable
insufficient	insuffisant
exaggerate	exagérer, amplifier, exagérer
wax	cirer, croître, épiler  à la cire, cire, encaustique, cire
preferred	préféré
viewpoint	point de vue
audit	contrôler, auditer, contrôle, révision, vérification, audit
sovereignty	État souverain, souveraineté
boxing	boxe, de boxe
applause	applaudissements
protocol	protocole d'accord, protocole
Olympics	Jeux olympiques, de l'Olympe, olympique
conform	se conformer, se conformer à, être conforme (à)
matrix	matrice
offspring	petit, progéniture, descendance
valve	valvule, valve, valve, soupape, valve
intake	entrée (d'air), consommation, inhalation, inspiration, admission, quantité (ingérée)
mat	tapis, petit tapis, paillasson
harmony	harmonie
retreat	se replier, refuge, retraite
whisky	whisky
consolidate	consolider, fusionner
repeated	répété, récurrent
offset	compenser  par, compensation, à l'écart, presse offset, offset, contrebalancer, compenser
retailer	détaillant, détaillante
appraisal	évaluation, évaluation, estimation, appréciation, évaluation, appréciation, évaluation, estimation
vaccine	vaccin
ash	frêne, cendres volcaniques, cendré, cendres
mercy	clémence, compassion, indulgence, pitié
curiosity	curiosité
deploy	déployer
weaken	faiblir, affaiblir, fragiliser, s'affaiblir, affaiblir
meaningful	significatif, significative
bulb	tête, ampoule, bulbe, oignon, bulbe, poire
merge	se rejoindre, fusionner  et, fusionner, fusionner en, se joindre à, fusionner  et  en
litter	détritus, déchets, jeter des détritus dans/sur, jeter des déchets dans/sur, jeter des détritus, jeter des déchets, portée, litière, civière
retention	rétention, mémoire, conservation
guardian	tuteur, tutrice
Buddhist	bouddhiste
solo	solo
telecommunications	de télécommunication, télécommunication
circulate	circuler, faire circuler
happily	gaiement, joyeusement, volontiers, heureusement
beating	raclée, correction, frapper, raclée, volée
prohibit	interdire à  de faire , défendre à  de faire, interdire, prohiber
bash	coup, cogner, frapper, fête, rentrer dans, descendre
wildly	frénétiquement, sauvagement, violemment, furieusement, extrêmement
continuation	continuation, prolongement, suite
embark	embarquer, s'embarquer dans
extensively	considérablement, beaucoup, en profondeur, en détail
jealous	jaloux, jalouse
vibrant	vivant, animé, vif, vive
deprive	priver  de
Buddhism	bouddhisme
stroll	se balader, petite promenade
photographic	photographique
debut	faire ses débuts, débuts, entrée dans le monde, premier, première
decree	décréter que, décret, décréter
preservation	protection, préservation
interference	ingérence, intrusion (dans les affaires des autres), interférence
outlet	prise (électrique, de courant), magasin d'usine, évacuer, écoulement, débouché, magasin, point de vente, évent
underwear	sous-vêtements
abundant	luxuriant, abondant
haul	prise, tirer, transporter
digger	pelleteuse, pelle mécanique, personne qui creuse
mainland	continental, continent
fake	faire semblant de faire, contrefaçon, simuler, contrefaire, imposteur, simuler, contrefaire, imiter, faux, fausse
gardening	jardinage
witch	sorcière, sorcier, sorcière
hatred	haine
embarrassing	embarrassant, gênant
handling	manipulation, manutention, frais de manutention, gestion, conduite
dip	diminuer, baisser, chuter, descendre, tremper, baignade, baisse, diminution, tremper  dans, pente, descente, sauce (froide)
habitat	habitat
indirectly	indirectement
mandate	mandat, ordre
overwhelming	irrésistible, accablant, écrasant, important
nuisance	pénible, ennuyeux, ennuyeuse
importantly	de manière importante, d'un ton important
accountability	responsabilité
underpin	étayer, étayer, soutenir
break out	éclater, sortir  de, s'évader, s'échapper,, avoir, apparaître, s'évader de , s'échapper de
tomb	tombe, la mort
irony	ironie
racism	racisme
stylish	chic, élégant, élégant
competent	compétent, qualifié, suffisant
breadth	largeur, largesse, ampleur
spark	vivacité, déclencher, une trace de, faire des étincelles, étincelle, opérateur radio, opératrice radio, électricien
suppress	censurer, réprimer, réprimer, retenir, contenir, refouler
browse	naviguer sur, naviguer (sur internet), regarder, coup d'œil, feuilleter
header	boutisse, en-tête, tête
sprout	chou de Bruxelles, pousser, germer, pousser comme des champignons, pousser (à ), germe
inability	incapacité
demolish	démolir, détruire, abattre, démolir, détruire, saper
